F 220,100,0
NO ./path_to_the_north_texture.xpm
SO ./path_to_the_south_texture.xpm
WE ./path_to_the_west_texture.xpm
EA ./path_to_the_east_texture.xpm
C 225,30,0
        1111111111111111111111111
        1000000000110000000000001
         1011000001110000000000001
        1001000000000000000000001
111111111011000001110000000000001
100000000011000001110111111111111
11110111111111011100000010001
111101111 11111011101010010001
11000000110101011100000010001
1000000000000011000000100001
10000000000000001101010010001
11000001110101011110111100111
11110111 1110101 101111010001
11111111 1111111 111111111111
1111111111
1000000001
1111111111
1111
10N1
1111



